NO textures/unnamed.png
WE textures/physical_graffiti.png
SO textures/fachada_dos.png
EA textures/toldo_verde_icon.png

F 0,32,0
C 120,0,16

 1111111      111111111111
110000011     1100000000011
100000001    110000000000011
110000011    1000000000000011
 1110111     10000000000000011
   101       110000011100000011
   101        1100001 100000001
   1011111111111000011100000011
   100000000000000000000000011
   10111111111110000000000011
   101        11000000000011
   101       11000000000011
 1110111     1000000000011
110000011    1000000N0001
100000001    110000000001
110000011     11000000001
 1111111       1111111111