SO textures/test/south.xpm
WE textures/test/west.xpm
EA textures/test/east.xpm
      NO textures/test/east.xpm

F 175, 20  , 300 
C 1,  255,200

    1111   11111111111
    1111111111111111
   1  100011 1000001
      100011 1000001
      100001 1111111
      101111
11111 111
10001
10001
11001
10E01
10001
10001
10001
10001
11111
